###############################
#P     ** *    *    E * * *   #
# # # #*# # #*#*# # # #*#*#*# #
#   *     ***  *      *       #
# # # # # #*# # #*#*# # # # # #
#            **  *  *         #
# # # # # # # # # #*# #*# # # #
#*  *      *  *      *        #
# # # # #*# # # #*#*# # # # # #
#*    **  *       *           #
# #*# # # # # # #*# # # # # # #
#           *   *  *          #
###############################
