#############################################################################
#                                                                           #
#                                                                           #
#                                                                           #
#                                                                           #
#                                                                           #
#                                                                           #
#                                                                           #
#                                                                           #
#                                        P                                  #
#                                                                           #
#                                                                           #
#                                                                           #
#                                                                           #
#                                                                           #
#                                                                           #
#                                                                           #
#                                                                           #
#                                                                           #
#                     O                                                     #
#                                                                           #
#                                                                           #
#                                                                           #
#                                                                           #
#                                                                           #
#                                                                           #
#                                                                           #
#                                                                           #
#############################################################################