##################
#   S    *       #
#   S    ###     #
#   S  P  *E#    #
#        ###     #
#   O      * f   #
##################
